Map 3
24 24
10 8
111111111111111111111111
100000000000000000000001
100000000000000000000001
100000000000000000000001
100000000000000000000001
100001100000000011000001
100001100000000011000001
100000000000000000000001
100000000000000000000001
100000000000000000000001
100000000000000000000001
100000000000000000000001
100000000111100000000001
100000000100100000000001
100000000110100000000001
100000000000000000000001
100000000000000000000001
100000000000000000000001
100000000000000000000001
100001000000000011000001
100000000000000011000001
100000000000000000000001
100000000000000000000001
111111111111111111111111
