Saxophone
77 41 60 20
11111111111111111111111111111111111111111111111111111111111111111111111111111
10000000000000000000000000000000000000000000000000000000000000000000000000001
10002220000222000022222200000000222222000022222200000022222220000020200000001
10002220000222000022202220000002220022200222002220000200000002000202020000001
10002220000222000022222200000022200002222220000222000200000002002002020000001
10002220000222000022202220000022200002222220000222000200000002002002020000001
10000222002220000022200222000022200000000000000222000200000002002000020000001
10000022222200000022200222000022200000000000000222000022222220002000020000001
10000000000000000000000000000000000000000000000000000000000000000000000000001
10000000000000000000000000000000000000000000000000000000000000000000000000001
10000000011111111111111100001111111111111110000000000000000000000000000000001
10000000111111111111111110011111111111111111000000000000000000000000000000001
10000001111111111111111111111111111111111111100000000000000000000000000000001
10000001111111111111111111111111111111111111100000000000000000000000000000001
10000001111111111111111111111111111111111111100000000000000000000000000000001
10000000111111111111111111111111111111111111000000000000000000000000000000001
10000000001111111111111111111111111111111110000000000000000000000000000000001
10000000000000000111111111111111111000000000000000000000000000000000000000001
10000000000000000111111111111111111000000000000000000000000000000000000000001
10000000000000000111111111111111111000000000000000000000000000000000000000001
10000000000000000111111111111111111000000000000000000000000000000000000000001
10000000000000000111111111111111111000000000000000000000000000000000000000001
10000000000000000111111111111111111000000000000000000000000000000000000000001
10000000000000000111111111111111111000000000000000000000000000000000000000001
10000000000000000111111111111111111000000000000000000000000000000000000000001
10000000000000000111111111111111111000000000000000000000000000000000000000001
10000000000000000111111111111111111000000000000000000000000000000000000000001
10000000000000000111111111111111111000000000000000000000000000000000000000001
10000000000000000111111111111111111000000000000000000000000000000000000000001
10000000000000000111111111111111111000000000000000000000000000000000000000001
10000000000000000111111111111111111000000000000000000000000000000000000000001
10000000000000000111111111111111111000000000000000000000000000000000000000001
10000000000000011111111111111111111110000000000000000000000000000000000000001
10000000000000111111111111111111111111000000000000000000000000000000000000001
10000000000000011111111111111111111110000000000000000000000000000000000000001
10000000000000000111111111111111111000000000000000000000000000000000000000001
10000000000000000001111111111111100000000000000000000000000000000000000000001
10000000000000000000011111111110000000000000000000000000000000000000000000001
10000000000000000000000111111000000000000000000000000000000000000000000000001
10000000000000000000000000000000000000000000000000000000000000000000000000001
11111111111111111111111111111111111111111111111111111111111111111111111111111

Monster  8  5
Monster 34  4
Monster 25 11
Monster 26 39
Monster 69 28
Monster  7 25
Monster 67  2