Saxophone
77 41 60 20
11111111111111111111111111111111111111111111111111111111111111111111111111111
10000000000000000000000000000000000000000000000000000000000000000000000000001
10001110000111000011111100000000111111000011111100000011111110000010100000001
10001110000111000011101110000001110011100111001110000100000001000101010000001
10001110000111000011111100000011100001111110000111000100000001001001010000001
10001110000111000011101110000011100001111110000111000100000001001001010000001
10000111001110000011100111000011100000000000000111000100000001001000010000001
10000011111100000011100111000011100000000000000111000011111110001000010000001
10000000000000000000000000000000000000000000000000000000000000000000000000001
10000000000000000000000000000000000000000000000000000000000000000000000000001
10000000011111111111111100001111111111111110000000000000000000000000000000001
10000000111111111111111110011111111111111111000000000000000000000000000000001
10000001111111111111111111111111111111111111100000000000000000000000000000001
10000001111111111111111111111111111111111111100000000000000000000000000000001
10000001111111111111111111111111111111111111100000000000000000000000000000001
10000000111111111111111111111111111111111111000000000000000000000000000000001
10000000001111111111111111111111111111111110000000000000000000000000000000001
10000000000000000111111111111111111000000000000000000000000000000000000000001
10000000000000000111111111111111111000000000000000000000000000000000000000001
10000000000000000111111111111111111000000000000000000000000000000000000000001
10000000000000000111111111111111111000000000000000000000000000000000000000001
10000000000000000111111111111111111000000000000000000000000000000000000000001
10000000000000000111111111111111111000000000000000000000000000000000000000001
10000000000000000111111111111111111000000000000000000000000000000000000000001
10000000000000000111111111111111111000000000000000000000000000000000000000001
10000000000000000111111111111111111000000000000000000000000000000000000000001
10000000000000000111111111111111111000000000000000000000000000000000000000001
10000000000000000111111111111111111000000000000000000000000000000000000000001
10000000000000000111111111111111111000000000000000000000000000000000000000001
10000000000000000111111111111111111000000000000000000000000000000000000000001
10000000000000000111111111111111111000000000000000000000000000000000000000001
10000000000000000111111111111111111000000000000000000000000000000000000000001
10000000000000011111111111111111111110000000000000000000000000000000000000001
10000000000000111111111111111111111111000000000000000000000000000000000000001
10000000000000011111111111111111111110000000000000000000000000000000000000001
10000000000000000111111111111111111000000000000000000000000000000000000000001
10000000000000000001111111111111100000000000000000000000000000000000000000001
10000000000000000000011111111110000000000000000000000000000000000000000000001
10000000000000000000000111111000000000000000000000000000000000000000000000001
10000000000000000000000000000000000000000000000000000000000000000000000000001
11111111111111111111111111111111111111111111111111111111111111111111111111111