The Only Map
50 40 48 38
44444444444444444444444444444444444444444444444444
44444444444444444444444444444444444444444444444444
44444444444444444444444444444444444444444444444444
44444444444444444444444444000000400000004444444444
44444444444444444400000000000000000000000444444444
44444444444444444404444440000000444444400044444444
44444444444444444404444440000000444444440004444444
44444444444444420004444440044444444444444000444444
44444444444444300004444440044444444444444400444444
44444444444444444444444440004444444444444400444444
33333333333333333333333333000333333333333300333333
33333333333333333333333333300333333333333300333333
33333333333333333333333333300333333333333300333333
33333333333333333333333333300333330000000000033333
33333333333333333333333333300000000000000000033333
33333333333333333333333333300000000000000000033333
33333333333333333333333333333333330000000000033333
33333333333333333333333333333333330000000000033333
33333333333333333333333333333333333000000000333333
33333333333333333333333333333333333300000003333333
22222222222222222222222222222222222220000022222222
22222222222222222222222222222222222220000022222222
22222222222222222222222222222222222220022002222222
22222222222222222222222222222222222200222200222222
22222222222222222222222222222222222000222200222222
22222222222222222222222222222222200002222200222222
22222222222222222222222222222220000022222220000222
22222222222222222222222222222200000222222222220222
22222222222222222222222222222000002222222200000222
22222222222222222222222222220000022222222200222222
11111111111111111111111111110000011111111100000111
11111111111111111111111111110010011111111110000011
11111111111111111111111111110010011111111111110001
11111111111111111111111111110010011111111111111001
11111111111111111111111111110010000111111111111001
11111111111111111111111111110011110111111111111001
11111111111111111111111111110011110000000000000001
11111111111111111111111111110011110000000000000001
11111111111111111111111111111000000111111111111001
11111111111111111111111111111111111111111111111111

Monster 38 37
Monster 30 29
Monster 42 24
Monster 34 13
Monster 44 13
Monster 39 15
Treasure 15 8
Monster 26 10
Monster 34  3
Monster 23  4
Monster 16  8
Monster 29  3