Level One
12 12 10 10
112111111111
120211000011
110000110111
113330330111
110000000331
100300000031
110111111011
110010000011
111010111111
111010100001
111000001101
111111111111

Monster  6 1
Monster  1 5
Monster  5 4
Treasure 2 1